22222222222222222222222222
20001010101000101012201012
20001010001210010101001102
20001010200010101110210002
22002200001000000100202002
20111000001012220202211002
20010100110210202001220002
20000010110010102100121002
22200111010010222220100122
21010100101000101010101002
22122122220002021022210002
22222222222222222222222222
