222222222222222222222222222222
200022101112000010022111100012
220200110020021000000101121012
210200020110102211111112201002
201000001000020200111211112022
211100211210111012202001001002
222102211121110100212110200002
210202002101121100110021120002
200000021121102100201000002022
201121012011101110112100201122
210001112222021200011210201002
201020001002120021112110210002
222002100111020001201202002202
211200210102020000012121011112
221101001011011111200102010102
200200000110010112111001221102
220121111021010100010000111102
222222222222222222222222222222
